# ######################################
#   ###     ##                      ## #
### ### ### #  ###### ######## #  # #  #
# #     # # ##      #        # #### # ##
# ####### # ##### # # ###### # #       #
#         #     # # #      # # #  ##   #
# ### ### ##### # # ######## # #####   #
# ### #     #   ###          # ##    ###
#     # ### # ######## #######  # #### #
# # # # ### #          ##    ## # ## # #
# # # #     ########## #   #### # ## # #
# # ##### #          # ### #    #      #
# #    ## #######  # # #      # ### ####
# #### ##   # # #### # #####  #   # #  #
# ## ## ###       ## #       ## # # # ##
## # #  ###### ## ## ####### ## # # # ##
#  # #       # ##                      #
###################################### #
